1111111111111111111111111111111111111111
1222222222222222222222222222222222222201
1200000200020000000000000002000200000201
1201111201120111111111111112011201111201
1201111201122222220112222222011201111201
1201122201100000020112000000011222011201
1201120001111111120112011111111002011201
1201120111111111120112011111111112011201
1201120111100000000000000000011112011201
1201122201100000000000000000011222011201
1201100201100111111001111110011200011201
1201111201100100000000000010011201111201
1201111201100100000000000010011201111201
1222222201100111111111111110011222222201
1200000201100000000110000000011200000201
1201111222220000000110000002222201111201
1201111200020111120112011112000001111201
1222222201120111120112011112011222222201
1200000201120112222222220112011200000201
1201111201120112000000020112011201111201
1201111201120112011111120112011201111201
1201122201120112011111120112011222011201
1201120001122222222222222222011002011201
1201120111100000020002000000011112011201
1201120111111111120112011111111112011201
1201122201111111120112011111111222011201
1201100201122222220112222222011200011201
1201111201120000000110000002011201111201
1201111201120111111111111112011201111201
1222222222222222222222222222222222222201
1000000000000000000000000000000000000001
1111111111111111111111111111111111111111